111111111111111111
1000000C00000000P1
100000000000000001
100111111111111001
100000000000001001
10C000000000001C01
10010011110C001111
100100000100000001
100100C00100000001
100100000111111001
100111100100C01001
10C0001000000010C1
10000E100000001001
111111111111111111