111111
1P01C1
10CE01
100101
111111
