11111111
100000C1
10C00001
10011001
100110C1
10011001
10P110E1
10011001
100110C1
1C011001
10000001
11111111