111111111111111
1000000100000E1
10C000010000001
100000010C00001
100000000000001
100000000000001
10000C010000001
100000010000C01
10P000010000001
111111111111111